z="\n"
ACz='he'
CCz='ec'
iHz='Gr'
vEz='na'
LBz='ye'
OFz='aw'
kDz=' u'
lEz='r"'
GBz='Pz'
sDz='at'
kEz='et'
HCz=' m'
wEz='be'
az='in'
pCz=' w'
UGz='w='
qFz='-9'
WFz='Ah'
yz='ag'
ABz='Lz'
pGz=' 4'
wz='/e'
YHz='$a'
JBz='8c'
jFz='{'
KDz=' i'
lFz='{1'
Kz='8a'
Wz='tp'
EFz='pe'
bDz='" '
FIz='py'
sGz=' 3'
IDz='tw'
PHz='$J'
HDz=' B'
oz='f3'
uGz=' 9'
lz='Tz'
bz='Wz'
IFz='y!'
RCz='di'
NEz='y '
SFz='lt'
qDz='t.'
XCz=' y'
cHz='$i'
JDz=': '
xGz='00'
IHz='t='
GDz='s.'
ICz='e '
iBz='oz'
sz='ht'
hGz=' +'
gFz='sN'
ODz=' /'
PDz='-['
MDz='fo'
uFz='$ '
mz='es'
vFz=']]'
cGz='[ '
WBz='nz'
ZDz='d"'
WHz='$W'
FHz='$m'
uz='ck'
lDz='nd'
HEz='ot'
rHz='2'
KHz='$B'
rBz=' ['
dDz='-R'
Rz='hz'
jGz='))'
wBz='1 '
fBz='12'
NHz='$F'
PEz='yp'
JCz='so'
LGz='ce'
jCz='on'
CFz='gh'
fFz='ti'
nCz='cu'
vz='Uz'
jEz='do'
dBz='ac'
vHz='ro'
JFz='$9'
wHz='ws'
TFz='qu'
VCz='wi'
jz='Iz'
OEz='bo'
yDz='t,'
yGz='7'
LHz='z$'
fEz=' k'
pHz='sl'
ADz='er'
mHz='om'
nFz='=~'
WGz='tc'
oHz='o!'
sHz=' x'
NCz='um'
cBz='cz'
Iz='.p'
EDz='gu'
lBz='42'
SCz='sc'
BDz=' o'
SGz='e?'
qHz='p '
qGz='65'
VHz='$U'
oBz='dz'
IEz='ai'
ECz=' "'
eCz='-n'
Vz='Bz'
tCz='wh'
fDz='y,'
uDz=' e'
rz='Az'
VFz='ub'
YFz='h,'
HBz='m/'
LFz='No'
vCz='iv'
fz='Yz'
bCz=' -'
LIz='w,'
OGz='0 '
GFz='ea'
dGz='2 '
iz='r.'
kFz='[['
tFz='3}'
ZFz=' f'
HHz=' 5'
LDz='n '
MFz='n'\'''
BIz='Fi'
QHz='$L'
kBz='mz'
mDz='st'
Pz='Xz'
hFz='r('
JGz='se'
oFz=' ^'
CEz='$3'
iDz=' I'
CHz='de'
MCz='rg'
MBz='Dz'
dHz='$k'
NGz='ee'
hz='Jz'
pBz='b7'
KGz='Ni'
mEz='$7'
JEz='n.'
QEz='of'
uCz=' g'
AIz='$t'
WDz='re'
XGz='h='
tDz='r '
NBz='//'
KFz='-t'
xEz=', '
DHz='v/'
gBz='bz'
BGz='Nr'
XBz='c7'
cFz='t'\'''
IGz='el'
FBz='gg'
NDz='rm'
LEz='al'
tEz='. '
Dz='Cz'
ZBz='r/'
XFz='hh'
YBz='Qz'
uBz='-l'
REz='t"'
oDz='d '
HIz='l '
sBz=' $'
PGz='99'
gGz='ow'
HGz='."'
yHz='w-'
Yz='62'
AGz='& '
hDz='ut'
yCz='mb'
pz='kz'
FDz='nt'
iEz='ca'
DDz='ar'
hBz='75'
vBz='t '
Jz='fz'
IBz='pz'
rGz='$4'
CDz='f '
bGz=' {'
hEz='w '
Tz='Rz'
rDz=' r'
ZGz='=0'
SEz='$5'
QDz='a-'
MEz=' v'
eEz='?.'
vGz='11'
tHz='-w'
ZHz='$c'
gDz=' b'
VEz='m '
TEz='-b'
OIz='h:'
Cz='"\n'
NFz='ge'
EEz='Oh'
UHz='$S'
KIz='w:'
qBz='if'
wCz='rr'
Az='z='
qCz='h '
pDz='ur'
nBz='6e'
DGz='&&'
Ax2='ev'
RDz='zA'
cDz='!='
QBz='Hz'
xTT='al'
DBz='ha'
QFz='e!'
aEz=' s'
DIz=' h'
RHz='$N'
MHz='$D'
aGz='()'
jHz='rf'
MIz='ed'
GGz='${'
oGz='ch'
BCz='n'
YDz='ep'
vDz='ri'
Fz='s:'
AEz='sn'
qEz='ma'
xFz='$2'
nEz='-I'
CBz='Ez'
GEz='o,'
mGz='(('
GCz='ve'
Mz='e9'
JHz='"$'
nGz='(m'
OBz='iz'
IIz='nv'
QGz='9,'
dEz='ra'
GHz='eq'
rFz=']{'
aBz='ez'
kz='te'
rCz='yo'
xz='Sz'
yFz=' &'
CIz='eg'
UFz='ir'
hHz='z"'
DFz='ty'
xDz='em'
DCz='ho'
xHz='x-'
nz='Zz'
FGz='8 '
lGz='=$'
CGz='4 '
Sz='7e'
kGz='gt'
uEz='If'
AHz=' ('
TGz='lo'
WEz='cl'
OCz='en'
pFz='[0'
iCz='I '
TDz='] '
ZEz='hy'
FFz='s,'
KBz='Gz'
qz='15'
nDz='an'
OHz='$H'
Gz=''\''\n'
BFz='g '
bEz='uc'
QCz='o '
aFz='! '
Oz='co'
UDz='..'
YCz='ou'
eHz='$o'
RBz='as'
BBz='g-'
PBz='cd'
tBz='# '
pEz='ay'
EGz='$6'
EBz='Vz'
Uz='im'
AFz='br'
XEz='ue'
SDz='-Z'
gCz=' ]'
kCz='ly'
nHz='gl'
dCz='fi'
VDz='./'
gz='1e'
BHz='&>'
Ez='='\'''
gHz='$r'
ZCz='ex'
yEz='ul'
lHz='ok'
DEz='-a'
Zz='Kz'
WCz='th'
HFz='ll'
RFz=''\''s'
UCz='s '
FCz='Gi'
KEz='3 '
dz='rz'
SBz='Mz'
aDz='$1'
bBz='d8'
wFz='}'
bFz='Le'
cz='s/'
fHz='$p'
fCz='10'
aCz='it'
KCz='me'
eBz='gz'
GIz='il'
sCz='u '
eDz='So'
RGz=' p'
yBz=' t'
fGz='(l'
Xz='lz'
TBz='la'
mFz='} '
VBz='b.'
YGz='hi'
EIz='ap'
XDz='cc'
LCz=' a'
oCz='ss'
oEz='lw'
mBz='jz'
wDz='c '
jBz='4a'
eFz='nc'
rEz='ke'
Qz='a6'
Nz='Oz'
PCz='ts'
xCz='nu'
Bz='"'
dFz='fu'
xBz=']\n'
jDz=''\''t'
wGz='$8'
uHz='ww'
bHz='$g'
eGz='$('
iFz=') '
YEz='le'
Hz='qz'
gEz='no'
ez='ng'
kHz='to'
JIz='bl'
FEz=' n'
tz='Fz'
BEz='t?'
VGz='0'
UBz='Nz'
NIz='ig'
TCz='us'
lCz=' d'
PFz='9 '
EHz='\n'
cCz='1'
SHz='$P'
THz='$Q'
hCz='\n '
sFz='1,'
Lz='az'
tGz='33'
aHz='$e'
cEz='a '
MGz='bu'
sEz='ad'
iGz=' 1'
UEz='I'\'''
XHz='$Y'
mCz='is'